#1.4
RUS = "countries/Russia.txt"
AUH = "countries/Austria-Hungary.txt"

#1.6
HJZ = "countries/Hejaz.txt"
ASR = "countries/Asir.txt"
JBS = "countries/Jabal Shammar.txt"
BAV = "countries/Bavaria.txt"	

#1.7
GAL = "countries/Galicia.txt"
DKB = "countries/Don Kuban.txt"				# Don Kuban Republic
TRM = "countries/Transamur.txt"				# Amur
VLN = "countries/Free Territory.txt"			# Vilna Teritoriya
SIB = "countries/Siberia.txt"				# Siberian Republic 1918
CRI = "countries/Crimea.txt"				# Crimean Republic 1918
MOU = "countries/Mountain Republic.txt"
KBN = "countries/Kuban Republic.txt"

#1.8
OST = "countries/Ostasien.txt"

#1.9
QIN = "countries/Qing.txt"
GDC = "countries/Guangdong.txt"
SCC = "countries/Sichuan.txt"
GZC = "countries/Guizhou.txt"
GMJ = "countries/Guominjun.txt"
HNC = "countries/Hunan.txt"
ZHC = "countries/Zhili.txt"
ANC = "countries/Anhui.txt"
ZHE = "countries/Zhejiang.txt"
FNG = "countries/Fengtian.txt"
JNC = "countries/Jiangsu.txt"
JXC = "countries/Jiangxi.txt"
SDC = "countries/Shandong.txt"
ROC = "countries/ROC.txt"
QBC = "countries/Quebec.txt"
RGS = "countries/Riograndense Republic.txt" 
RYU = "countries/Ryukyu Kingdom.txt"